.	.	.	.	.	B	.	.	.
.	.	.	.	.	.	.	.	.
.	.	B	d	.	.	.	.	.
.	.	c	d	b	b	b	b	B
0	.	c	d	.	a	A	A	A
.	.	c	B	.	a	.	.	.
.	.	c	.	.	a	.	.	.
.	.	.	.	.	B	.	.	.
.	B	e	e	e	.	B	.	.